# # # # # # # # # # # # # # # # #
# T . . . . . . . . . # . # . . #
# # # # # . # # # . . . . # . # #
# . . . . . . . . . # . . . . . #
# . # # # . # . # . # . # . # . #
# . # . # . # . # . # . # . # . #
# . # . # . # . # . . # # . # . #
# . # . . . # . # # . # . # . . #
# . . . # # # . . # . . . . . # #
# . . . . . . . # # . # # . . . #
# # # # . # . . . # . # . . # . #
# . . . . # . # . . . # # . # . #
# . # # . # . # . # . . . . . . #
# S # # # # # # # # # # # # # # #
